******
*O * *
*    *
* * **
*   P*
******